1111111111111111111
1P00000000000000C01
100000000C111111111
1000111111100000001
100000000C000000C01
1C00000011111111111
10000000000C00000E1
1111111111111111111